29 26
************--************
*----*-----*--*-----*----*
*----*-----*--*-----*----*
*----*-----*--*-----*----*
**************************
-----*--*--------*--*----*
-----*--*--------*--*----*
******--****--****--******
-----*-----*--*-----*-----
-----*-----*--*-----*-----
-----*--**********--*-----
-----*--*--------*--*-----
-----*--*--------*--*-----
*********--------********$
-----*--*--------*--*-----
-----*--*--------*--*-----
-----*--**********--*-----
-----*--*--------*--*-----
-----*--*--------*--*-----
************--************
*----*-----*--*-----*----*
*----*-----*--*-----*----*
***--****************--***
--*--*--*--------*--*--*--
--*--*--*--------*--*--*--
******--*#**--****--******
*----------*--*----------*
*----------*--*----------*
**************************