15 80
***#********--************-----****************---------*---------------------
*----*-----*--*-----*----*******--------------*-----*****---------------*----*
*----*--------------*----**----***********----*-----*---***********-----*----*
*----*-----*--*-----*----**----*--------------*-----*---*---------*-----*----*
********************************---------****************---------************
-----*--*--------*--*----*-----*--*--------*--*----*----*---*--------*--*----*
-----*--*--------*--*----**----***********----*----*----***********-----*----*
******--****--****--************---------****************---------************
*----*-----*--*-----*----*******--------------*-----*****---------------*----*
*----*--------------*----**----***********----*-----*---***********-----*----*
*----*-----*--*-----*----**----*--------------*-----*---*---------*-----*----*
********************************---------****************---------************
-----*--*--------*--*----*-----*--*--------*--*----*----*------------*--*----*
-----*--*--------*--*----**----***********----*----*----***********-----*----*
******--****--****--************---------****************---------****$*******


