15 80
************--************-----****************---------*---------------------
*----*-----*--*-----*----*******--------------*-----*****---------------*----*
*----*--------------*----**----***********----*-----*---***********-----*----*
*----*-----*--*-----*----**----*--------------*-----*---*---------*-----*----*
********************************---------****************---------************
-----*--*--------*--*----*-----*--*--------*--*----*----*---*--------*--*----*
-----*--*--------*--*----**----***********----*----*----*****$*****-----*----*
******--****--****--************---------****************---------************
*----*-----*--*-----*----*******--------------*-----*****---------------*----*
*----*--------------*----**----***********----*-----*---***********-----*----*
*----*-----*--*-----*----**----*--------------*-----*---*---------*-----*----*
*****************#**************---------****************---------************
-----*--*--------*--*----*-----*--*--------*--*----*----*---*--------*--*----*
-----*--*--------*--*----**----***********----*----*----***********-----*----*
******--****--****--************---------****************---------************


