15 80
************--************-----****************---------*---------------------
*----*-----*--*-----*----*******--------------*-----*****---------------*----*
*----*--------------*----**----*****#*****----*-----*---***********-----*----*
*----*-----*--*-----*----**----*--------------*-----*---*---------*-----*----*
********************************---------****************---------************
-----*--*--------*--*----*-----*--*--------*--*----*----*---*--------*--*----*
-----*--*--------*--*----**----***********----*----*----***********-----*----*
******--****--****--************---------****************---------************
*----*-----*--*-----*----*******--------------*-----*****---------------*----*
*----*--------*-----*----**----***********----*-----*---***********-----*----*
*----*-----*--*-----*----**----*--------------*-----*---*---------*-----*----*
************$*******************---------****************---------************
-----*--*--------*--*----*-----*--*--------*--*----*----*---*--------*--*----*
-----*--*--------*--*----**----***********----*----*----***********-----*----*
******--****--****--************---------****************---------************


